111111111
100001001
100001C01
100001111
1P0E00001
111111111
