11111111111111111111111
1PC00000000000000000CE1
11111111111111111111111
