111111
1P0001
1000C1
101111
100001
111101
1E0001
111111
