111111111111111111111111111
1CCCCCCCCCCCCCCCCCCCCCCCCC1
1CCCCCCCCCCCCCCCCCCCCCCCCC1
1CCCCCCCCCCCCPCCCCCCCCCCCC1
1CCCCCCCCCCCCCCCCCCCCCCCCE1
111111111111111111111111111
