111111111
1PE000001
111111111
