11111
10001
10001
100C1
10E01
11111
