11111C1
1P00001
1E00001
1111111
