11111111111
1P0000C0001
1000E000001
10000010001
1000000001
1111111111
