111111111
100001001
100000C01
100101111
1P1E10001
111111111
